R 1920 1080 

NO ./textures/mossy.xpm
SO ./textures/diamond.xpm
WE ./textures/stone.xpm
EA ./textures/hexagone.xpm

S ./textures/barrel2.xpm
F 000,100,50
C 100,40,35

        1111111111111111111111111
   111  1000000000110000000000001
   101  1011000001110000002000001
   111  10010000000000S0000000001
111111111011000001110000000000001
100000000011000001110111111111111
11110111111111011100000010001
1111011111111101110101001000111
1100000011010101110000001000001
1000200000000000110000001000111
100000000000000001101010010001
1100000111010101111101111000111
11110111 1110101 101111010001
11111111 1111111 11111111111
