R 1000 800

NO ./textures/mossy.xpm
SO ./textures/mossy.xpm
WE ./textures/mossy.xpm
EA ./textures/mossy.xpm

S ./textures/mossy.xpm
F 200,100,50
C 150,111,35

        1111111111111111111111111
   111  1000000000110000000000001
   101  1011000001110000002000001
   111  1001000000000000000000001
111111111011000001110000000000001
100000000011000001110111111111111
11110111111111011100000010001
1111011111111101110101001000111
1100000011010101110000001000001
1000200000000000110000001000111
100000N00000000001101010010001
1100000111010101111101111000111
11110111 1110101 101111010001
11111111 1111111 111111111111
