R 1100 800 

NO ./textures/mossy.xpm
SO ./textures/mossy.xpm
WE ./textures/mossy.xpm
EA ./textures/mossy.xpm

S ./textures/mossy.xpm
F 000,100,50
C 100,40,35

11111111111111111111111111111111111
1S100000000000000100000000000000001
10101111111111110100000000000000001
10101010000000010111111000000000001
10101000111111010100000000000000001
10001010000000000101111100000000001
11111010000000010101000000000000001
10100011111111110111000000000000001
10001000000000000000000000000000001
10111111111111111111111111110000001
10000000000000000000000000000000001
10000000000000000000000000000000001
10000000000000000000000000000000001
11111111111111111111111111111111111
