R 1500 1000

NO ./textures/bluegreyl.xpm
SO ./textures/redbrick.xpm
WE ./textures/mossy.xpm
EA ./textures/wood.xpm
DO ./textures/door.xpm

S1 ./textures/barrel2.xpm
S2 ./textures/dog.xpm
S3 ./textures/vase2.xpm
S4 ./textures/vase.xpm
WEA ./textures/pistol1.xpm ./textures/pistol2.xpm

F ./textures/diamond.xpm 
C ./textures/sky2.xpm

1111111111111111111111111111111111111111111
10E00000200000000000000000000300000000051
10101111H11111110100000000000000002000001
10D01010000000010111111000030000001111111
10101000111111010100000000002000001
10001010000000000101111100000000001
1H111010000000010101000000000005501
10100011111111110111005500030000001
10001000000000000000005500000000001
10111111111111111111111111110000001
10000000000030000000000000000000001
10030000000000000000000300000000001
10000000000000000000000000000000001
11111111111111111111111111111111111
