R 1500 1000 

NO ./textures/stone.xpm
SO ./textures/redbrick.xpm
WE ./textures/mossy.xpm
EA ./textures/wood.xpm

S ./textures/barrel1.xpm
F ./textures/diamond.xpm 
C ./textures/sky_marseille.xpm

11111111111111111111111111111111111
10E00000000000000000000000000000001
10101111111111110100000000000000001
10101010000000010111111000000000001
10101000111111010100000000002000001
10001010000000000101111100000010001
11111010000000010101000000000000001
10100011111111110111000000000000001
10001000000000000000000000000000001
10111111111111111111111111110000001
10000000000000000000000000000000001
10000000000000000000000000000000001
10000000000000000000000000000000001
11111111111111111111111111111111111
